1 1 1 1 1 1 1 0 0 0 0 0 0 0 0 0 0 0 0 0 0
1 12 12 12 12 12 1 0 0 0 0 0 0 0 0 0 0 0 0 0 0
1 12 12 12 12 12 1 0 0 0 0 0 0 0 0 0 0 0 0 0 0
1 12 12 12 12 12 1 0 0 0 0 0 0 0 0 0 0 0 0 0 0
1 1 1 12 1 1 1 0 0 0 0 0 0 0 0 0 0 0 0 0 0
0 0 0 0 0 0 0 0 0 0 0 0 0 0 0 0 0 0 0 0 0
0 9 8 7 0 0 0 0 0 0 0 0 0 2 2 2 0 0 0 0 0
0 10 3 6 0 0 13 0 0 0 0 2 2 2 2 2 0 0 0 0 0
0 11 4 5 0 0 0 0 0 2 2 2 2 2 2 2 0 0 0 0 0
0 0 0 0 0 0 2 2 2 2 2 2 2 2 2 2 0 0 0 0 0
0 0 0 0 0 2 2 2 2 2 2 2 2 2 2 2 0 0 0 0 0
0 0 0 0 2 2 2 2 2 2 2 2 2 2 2 2 0 0 0 0 0
